{
    "side": 20,
    "step": 50,
    "heightmap":
    [
        0,  0,  0,  0,  0,  0,  0,  0,  0,  0,  0,  0,  0,  0,  0,  0,  0,  0,  0,  0,
        0,  0,  0,  0,  0,  0,  0,  0,  0,  0,  0,  0,  0,  0,  0,  0,  0,  0,  0,  0,
        0,  0,  0,  0,  0,  0,  0,  0,  0,  0,  0,  0,  0,  0,  0,  0,  0,  0,  0,  0,
        0,  0,  0, 50, 50,  0,  0,  0,  0,  0,  0,  0, 50, 50, 50,  0,  0,  0,  0,  0,
        0,  0,  0, 50, 50,  0,  0,  0,  0,  0,  0,  0, 50, 50, 50, 50,  0,  0,  0,  0,
        0,  0,  0, 50, 50,  0,  0,  0,  0,  0,  0, 50, 50,  0, 50, 50, 50,  0,  0,  0,
        0,  0,  0, 50, 50,  0,  0,  0,  0,  0,  0, 50, 50,  0,  0, 50, 50,  0,  0,  0,
        0,  0,  0, 50, 50,  0,  0,  0,  0,  0,  0, 50, 50,  0,  0, 50, 50,  0,  0,  0,
        0,  0,  0, 50, 50,  0,  0,  0,  0,  0,  0,  0,  0,  0,  0, 50, 50,  0,  0,  0,
        0,  0,  0, 50, 50, 50, 50, 50,  0,  0,  0,  0,  0,  0, 50, 50, 50,  0,  0,  0,
        0,  0,  0, 50, 50, 50, 50, 50,  0,  0,  0,  0,  0, 50, 50, 50,  0,  0,  0,  0,
        0,  0,  0, 50, 50, 50, 50, 50,  0,  0,  0,  0, 50, 50, 50,  0,  0,  0,  0,  0,
        0,  0,  0,  0,  0, 50, 50,  0,  0,  0,  0, 50, 50, 50,  0,  0,  0,  0,  0,  0,
        0,  0,  0,  0,  0, 50, 50,  0,  0,  0,  0, 50, 50,  0,  0,  0,  0,  0,  0,  0,
        0,  0,  0,  0,  0, 50, 50,  0,  0,  0,  0, 50, 50, 50, 50, 50, 50,  0,  0,  0,
        0,  0,  0,  0,  0, 50, 50,  0,  0,  0,  0, 50, 50, 50, 50, 50, 50,  0,  0,  0,
        0,  0,  0,  0,  0, 50, 50,  0,  0,  0,  0, 50, 50, 50, 50, 50, 50,  0,  0,  0,
        0,  0,  0,  0,  0,  0,  0,  0,  0,  0,  0,  0,  0,  0,  0,  0,  0,  0,  0,  0,
        0,  0,  0,  0,  0,  0,  0,  0,  0,  0,  0,  0,  0,  0,  0,  0,  0,  0,  0,  0,
        0,  0,  0,  0,  0,  0,  0,  0,  0,  0,  0,  0,  0,  0,  0,  0,  0,  0,  0,  0
    ]
}
